192 128
################################################################################################################################################################################################
################################################################################################################################################################################################
################################################################################################################################################################################################
################################################################################################################################################################################################
################################################################################################################################################################################################
################################################################################################################################################################################################
################################################################################################################################################################################################
################################################################################################################################################################################################
################################################################################################################################################################################################
################################################################################################################################################################################################
################################################################################################################################################################################################
################################################################################################################################################################################################
################################################################################################################################################################################################
################################################################################################################################################################################################
################################################################################################################################################################################################
################################################################################################################################################################################################
################################################################################################################################################################################################
################################################################################################################################################################################################
################################################################################################################################################################################################
################################################################################################################################################################################################
################################################################################################################################################################################################
################################################################################################################################################################################################
################################################################################################################################################################################################
################################################################################################################################################################################################
################################################################################################################################################################################################
################################################################################################################################################################################################
################################################################################################################################################################################################
################################################################################################################################################################################################
################################################################################################################################################################################################
################################################################################################################################################################################################
################################################################################################################################################################################################
################################################################################################################################################################################################
################################################################################################################################################################################################
################################################################################################################################################################################################
################################################################################################################################################################################################
################################################################################################################################################################################################
################################################################################################################################################################################################
################################################################################################################################################################################################
################################################################################################################################################################################################
################################################################################################################################################################################################
################################################################################################################################################################################################
################################################################################################################################################################################################
################################################################################################################################################################################################
################################################################################################################################################################################################
################################################################################################################################################################################################
################################################################################################################################################################################################
################################################################################################################################################################################################
################################################################################################################################################################################################
################################################################################################################################################################################################
################################################################################################################################################################################################
################################################################################################################################################################################################
################################################################################################################################################################################################
##############################################C#################################################################################################################################################
########################################2000000000000001################################################################################2000000000000001########################################
#######################################200000000000000001##############################################################################200000000000000001#######################################
######################################20000000000000000001############################################################################20000000000000000001######################################
#####################################2000000000000000000001##########################################################################2000000000000000000001#####################################
####################################200000000000000000000001########################################################################200000000000000000000001C###################################
###################################20000000000000000000000001######################################################################20000000000000000000000001###################################
##################################2000000000000000000000000001####################################################################2000000000000000000000000001##################################
#################################200000000000000000000000000001##################################################################200000000000000000000000000001#################################
################################20000000000000000000000000000001################################################################20000000000000000000000000000001################################
###############################2000000000000000000000000000000001##############################################################2000000000000000000000000000000001###############################
##############################200000000000000000000000000000000001############################################################200000000000000000000000000000000001##############################
#############################20000000000000000000000000000000000001##########################################################20000000000000000000000000000000000001#############################
###########################c2000000000000000000000000000000000000001########################################################2000000000000000000000000000000000000001############################
###########################200000000000003############400000000000001######################################################200000000000003############400000000000001###########################
##########################200000000000003##############400000000000001####################################################200000000000003##############400000000000001##########################
#########################200000000000003################400000000000001#################################################C200000000000003################400000000000001#########################
########################200000000000003##################400000000000001################################################200000000000003##################400000000000001########################
#######################200000000000003####################400000000000001##############################################200000000000003####################400000000000001#######################
######################200000000000003######################400000000000001############################################200000000000003######################400000000000001######################
#####################200000000000003########################400000000000001##########################################200000000000003########################400000000000001#####################
####################200000000000003##########################400000000000001########################################200000000000003##########################400000000000001####################
###################200000000000003############################400000000000001######################################200000000000003############################400000000000001###################
##################200000000000003##############################400000000000001####################################200000000000003##############################400000000000001##################
#################200000000000003################################400000000000001##################################200000000000003################################400000000000001#################
################200000000000003##################################400000000000001################################200000000000003##################################400000000000001################
###############200000000000003####################################400000000000001##############################200000000000003####################################400000000000001###############
##############200000000000003######################################400000000000001############################200000000000003######################################400000000000001##############
000000000000000000000000000000000000000000000000000000000000000000000000000000000000000000000000000000000000000000000000000000000000000000000000000000000000000000000000000000000000000000000000
000000000000000000000000000000000000000000000000000000000000000000000000000000000000000000000000000000000000000000000000000000000000000000000000000000000000000000000000000000000000000000000000
000000000000000000000000000000000000000000000000000000000000000000000000000000000000000000000000000000000000000000000000000000000000000000000000000000000000000000000000000000000000000000000000
000000000000000000000000000000000000000000000000000000000000000000000000000000000000000000000000000000000000000000000000000000000000000000000000000000000000000000000000000000000000000000000000
000000000000000000000000000000000000000000000000000000000000000000000000000000000000000000000000000000000000000000000000000000000000000000000000000000000000000000000000000000000000000000000000
000000000000000000000000000000000000000000000000000000000000000000000000000000000000000000000000000000000000000000000000000000000000000000000000000000000000000000000000000000000000000000000000
000000000000000000000000000000000000000000000000000000000000000000000000000000000000000000000000000000000000000000000000000000000000000000000000000000000000000000000000000000000000000000000000
000000000000000000000000000000000000000000000000000000000000000000000000000000000000000000000000000000000000000000000000000000000000000000000000000000000000000000000000000000000000000000000000
000000000000000000000000000000000000000000000000000000000000000000000000000000000000000000000000000000000000000000000000000000000000000000000000000000000000000000000000000000000000000000000000
000000000000000000000000000000000000000000000000000000000000000000000000000000000000000000000000000000000000000000000000000000000000000000000000000000000000000000000000000000000000000000000000
000000000000000000000000000000000000000000000000000000000000000000000000000000000000000000000000000000000000000000000000000000000000000000000000000000000000000000000000000000000000000000000000
000000000000000000000000000000000000000000000000000000000000000000000000000000000000000000000000000000000000000000000000000000000000000000000000000000000000000000000000000000000000000000000000
000000000000000000000000000000000000000000000000000000000000000000000000000000000000000000000000000000000000000000000000000000000000000000000000000000000000000000000000000000000000000000000000
##############200000000000000000003##########################################################################################################################400000000000000000001##############
#############200000000000000000003############################################################################################################################400000000000000000001#############
############200000000000000000003##############################################################################################################################400000000000000000001############
###########200000000000000000003################################################################################################################################400000000000000000001###########
##########200000000000000000003##################################################################################################################################400000000000000000001##########
#########200000000000000000003####################################################################################################################################400000000000000000001#########
########200000000000000000003######################################################################################################################################400000000000000000001########
#######200000000000000000003########################################################################################################################################400000000000000000001#######
######200000000000000000003##########################################################################################################################################400000000000000000001######
#####200000000000000000003############################################################################################################################################400000000000000000001#####
####200000000000000000003##############################################################################################################################################400000000000000000001####
###200000000000000000003################################################################################################################################################400000000000000000001###
##200000000000000000003##################################################################################################################################################400000000000000000001##
#200000000000000000003####################################################################################################################################################400000000000000000001#
200000000000000000003######################################################################################################################################################400000000000000000001
00000000000000000003########################################################################################################################################################40000000000000000000
0000000000000000003##########################################################################################################################################################4000000000000000000
000000000000000003############################################################################################################################################################400000000000000000
00000000000000003##############################################################################################################################################################40000000000000000
0000000000000003################################################################################################################################################################4000000000000000
000000000000003##################################################################################################################################################################400000000000000
00000000000003####################################################################################################################################################################40000000000000
0000000000003######################################################################################################################################################################4000000000000
000000000003########################################################################################################################################################################400000000000
00000000003##########################################################################################################################################################################40000000000
0000000003############################################################################################################################################################################4000000000
000000003##############################################################################################################################################################################400000000
00000003################################################################################################################################################################################40000000
0000003##################################################################################################################################################################################4000000
000003####################################################################################################################################################################################400000
00003######################################################################################################################################################################################40000
0003########################################################################################################################################################################################4000
003##########################################################################################################################################################################################400
03############################################################################################################################################################################################40
3##############################################################################################################################################################################################4