192 128
################################################################################################################################################################################################
################################################################################################################################################################################################
################################################################################################################################################################################################
################################################################################################################################################################################################
################################################################################################################################################################################################
################################################################################################################################################################################################
################################################################################################################################################################################################
################################################################################################################################################################################################
################################################################################################################################################################################################
################################################################################################################################################################################################
################################################################################################################################################################################################
################################################################################################################################################################################################
################################################################################################################################################################################################
################################################################################################################################################################################################
################################################################################################################################################################################################
################################################################################################################################################################################################
################################################################################################################################################################################################
################################################################################################################################################################################################
################################################################################################################################################################################################
################################################################################################################################################################################################
################################################################################################################################################################################################
################################################################################################################################################################################################
################################################################################################################################################################################################
################################################################################################################################################################################################
################################################################################################################################################################################################
################################################################################################################################################################################################
################################################################################################################################################################################################
################################################################################################################################################################################################
################################################################################################################################################################################################
################################################################################################################################################################################################
################################################################################################################################################################################################
################################################################################################################################################################################################
################################################################################################################################################################################################
################################################################################################################################################################################################
################################################################################################################################################################################################
################################################################################################################################################################################################
################################################################################################################################################################################################
################################################################################################################################################################################################
################################################################################################################################################################################################
################################################################################################################################################################################################
################################################################################################################################################################################################
################################################################################################################################################################################################
################################################################################################################################################################################################
################################################################################################################################################################################################
################################################################################################################################################################################################
################################################################################################################################################################################################
################################################################################################################################################################################################
################################################################################################################################################################################################
################################################################################################################################################################################################
################################################################################################################################################################################################
1##############################################################################################################################################################################################2
01############################################################################################################################################################################################20
001##########################################################################################################################################################################################200
0001########################################################################################################################################################################################2000
00001######################################################################################################################################################################################20000
000001####################################################################################################################################################################################200000
0000001##################################################################################################################################################################################2000000
00000001################################################################################################################################################################################20000000
000000001##############################################################################################################################################################################200000000
0000000001############################################################################################################################################################################2000000000
00000000001##########################################################################################################################################################################20000000000
000000000001########################################################################################################################################################################200000000000
0000000000001######################################################################################################################################################################2000000000000
00000000000001####################################################################################################################################################################20000000000000
000000000000001##################################################################################################################################################################200000000000000
0000000000000001################################################################################################################################################################2000000000000000
00000000000000001##############################################################################################################################################################20000000000000000
000000000000000001############################################################################################################################################################200000000000000000
0000000000000000001##########################################################################################################################################################2000000000000000000
00000000000000000001########################################################################################################################################################20000000000000000000
000000000000000000001######################################################################################################################################################200000000000000000000
0000000000000000000001####################################################################################################################################################2000000000000000000000
00000000000000000000001##################################################################################################################################################20000000000000000000000
000000000000000000000001################################################################################################################################################200000000000000000000000
0000000000000000000000001c#############################################################################################################################################2000000000000000000000000
00000000000000000000000001############################################################################################################################################20000000000000000000000000
000000000000000000000000001##########################################################################################################################################200000000000000000000000000
0000000000000000000000000001########################################################################################################################################2000000000000000000000000000
00000000000000000000000000001######################################################################################################################################20000000000000000000000000000
000000000000000000000000000001####################################################################################################################################200000000000000000000000000000
0000000000000000000000000000001##################################################################################################################################2000000000000000000000000000000
00000000000000000000000000000001################################################################################################################################20000000000000000000000000000000
000000000000000000000000000000001##############################################################################################################################200000000000000000000000000000000
0000000000000000000000000000000001############################################################################################################################2000000000000000000000000000000000
00000000000000000000000000000000001############################################################c#############################################################20000000000000000000000000000000000
000000000000000000000000000000000001################################################200000000000000000000001################################################200000000000000000000000000000000000
0000000000000000000000000000000000001##############################################20000000000000000000000001##############################################2000000000000000000000000000000000000
00000000000000000000000000000000000001############################################2000000000000000000000000001############################################20000000000000000000000000000000000000
000000000000000000000000000000000000001##########################################200000000000000000000000000001##########################################200000000000000000000000000000000000000
0000000000000000000000000000000000000001########################################20000000000000000000000000000001########################################2000000000000000000000000000000000000000
00000000000000000000000000000000000000001######################################2000000000000000000000000000000001######################################20000000000000000000000000000000000000000
000000000000000000000000000000000000000001####################################200000000000000000000000000000000001###################################c200000000000000000000000000000000000000000
0000000000000000000000000000000000000000001##################################20000000000000000000000000000000000001##################################2000000000000000000000000000000000000000000
00000000000000000000000000000000000000000001################################2000000000000000000000000000000000000001################################20000000000000000000000000000000000000000000
000000000000000000000000000000000000000000001##############################200000000000000000000000000000000000000001##############################200000000000000000000000000000000000000000000
0000000000000000000000000000000000000000000001############################20000000000000000000000000000000000000000001############################2000000000000000000000000000000000000000000000
00000000000000000000000000000000000000000000001##########################2000000000000000000000000000000000000000000001##########################20000000000000000000000000000000000000000000000
000000000000000000000000000000000000000000000001########################200000000000000000000000000000000000000000000001########################200000000000000000000000000000000000000000000000
0000000000000000000000000000000000000000000000001#####################C20000000000000000000000000000000000000000000000001######################2000000000000000000000000000000000000000000000000
00000000000000000000000000000000000000000000000001####################2000000000000000000000000000000000000000000000000001####################20000000000000000000000000000000000000000000000000
000000000000000000000000000000000000000000000000001##################200000000000000000000000000000000000000000000000000001##################200000000000000000000000000000000000000000000000000
0000000000000000000000000000000000000000000000000001################20000000000000000000000000000000000000000000000000000001################2000000000000000000000000000000000000000000000000000
00000000000000000000000000000000000000000000000000001##############2000000000000000000000000000000000000000000000000000000001##############20000000000000000000000000000000000000000000000000000
000000000000000000000000000000000000000000000000000001############200000000000000000000000000000000000000000000000000000000001############200000000000000000000000000000000000000000000000000000
0000000000000000000000000000000000000000000000000000001##########20000000000000000000000000000000000000000000000000000000000001##########2000000000000000000000000000000000000000000000000000000
00000000000000000000000000000000000000000000000000000001########2000000000000000000000000000000000000000000000000000000000000001########20000000000000000000000000000000000000000000000000000000
000000000000000000000000000000000000000000000000000000001######200000000000000000000000000000000000000000000000000000000000000001######200000000000000000000000000000000000000000000000000000000
0000000000000000000000000000000000000000000000000000000001####20000000000000000000000000000000000000000000000000000000000000000001####2000000000000000000000000000000000000000000000000000000000
00000000000000000000000000000000000000000000000000000000001##2000000000000000000000000000000000000000000000000000000000000000000001##20000000000000000000000000000000000000000000000000000000000
000000000000000000000000000000000000000000000000000000000001200000000000000000000000000000000000000000000000000000000000000000000001200000000000000000000000000000000000000000000000000000000000
000000000000000000000000000000000000000000000000000000000000000000000000000000000000000000000000000000000000000000000000000000000000000000000000000000000000000000000000000000000000000000000000
000000000000000000000000000000000000000000000000000000000000000000000000000000000000000000000000000000000000000000000000000000000000000000000000000000000000000000000000000000000000000000000000
000000000000000000000000000000000000000000000000000000000000000000000000000000000000000000000000000000000000000000000000000000000000000000000000000000000000000000000000000000000000000000000000
000000000000000000000000000000000000000000000000000000000000000000000000000000000000000000000000000000000000000000000000000000000000000000000000000000000000000000000000000000000000000000000000
000000000000000000000000000000000000000000000000000000000000000000000000000000000000000000000000000000000000000000000000000000000000000000000000000000000000000000000000000000000000000000000000
000000000000000000000000000000000000000000000000000000000000000000000000000000000000000000000000000000000000000000000000000000000000000000000000000000000000000000000000000000000000000000000000
000000000000000000000000000000000000000000000000000000000000000000000000000000000000000000000000000000000000000000000000000000000000000000000000000000000000000000000000000000000000000000000000
000000000000000000000000000000000000000000000000000000000000000000000000000000000000000000000000000000000000000000000000000000000000000000000000000000000000000000000000000000000000000000000000
000000000000000000000000000000000000000000000000000000000000000000000000000000000000000000000000000000000000000000000000000000000000000000000000000000000000000000000000000000000000000000000000
000000000000000000000000000000000000000000000000000000000000000000000000000000000000000000000000000000000000000000000000000000000000000000000000000000000000000000000000000000000000000000000000
000000000000000000000000000000000000000000000000000000000000000000000000000000000000000000000000000000000000000000000000000000000000000000000000000000000000000000000000000000000000000000000000
000000000000000000000000000000000000000000000000000000000000000000000000000000000000000000000000000000000000000000000000000000000000000000000000000000000000000000000000000000000000000000000000
000000000000000000000000000000000000000000000000000000000000000000000000000000000000000000000000000000000000000000000000000000000000000000000000000000000000000000000000000000000000000000000000
000000000000000000000000000000000000000000000000000000000000000000000000000000000000000000000000000000000000000000000000000000000000000000000000000000000000000000000000000000000000000000000000
000000000000000000000000000000000000000000000000000000000000000000000000000000000000000000000000000000000000000000000000000000000000000000000000000000000000000000000000000000000000000000000000
000000000000000000000000000000000000000000000000000000000000000000000000000000000000000000000000000000000000000000000000000000000000000000000000000000000000000000000000000000000000000000000000
000000000000000000000000000000000000000000000000000000000000000000000000000000000000000000000000000000000000000000000000000000000000000000000000000000000000000000000000000000000000000000000000
000000000000000000000000000000000000000000000000000000000000000000000000000000000000000000000000000000000000000000000000000000000000000000000000000000000000000000000000000000000000000000000000