192 128
################################################################################################################################################################################################
################################################################################################################################################################################################
################################################################################################################################################################################################
################################################################################################################################################################################################
################################################################################################################################################################################################
################################################################################################################################################################################################
################################################################################################################################################################################################
################################################################################################################################################################################################
################################################################################################################################################################################################
################################################################################################################################################################################################
################################################################################################################################################################################################
################################################################################################################################################################################################
################################################################################################################################################################################################
################################################################################################################################################################################################
################################################################################################################################################################################################
################################################################################################################################################################################################
################################################################################################################################################################################################
################################################################################################################################################################################################
################################################################################################################################################################################################
################################################################################################################################################################################################
################################################################################################################################################################################################
################################################################################################################################################################################################
################################################################################################################################################################################################
################################################################################################################################################################################################
################################################################################################################################################################################################
################################################################################################################################################################################################
################################################################################################################################################################################################
################################################################################################################################################################################################
################################################################################################################################################################################################
################################################################################################################################################################################################
################################################################################################################################################################################################
################################################################################################################################################################################################
################################################################################################################################################################################################
################################################################################################################################################################################################
################################################################################################################################################################################################
################################################################################################################################################################################################
################################################################################################################################################################################################
################################################################################################################################################################################################
################################################################################################################################################################################################
################################################################################################################################################################################################
################################################################################################################################################################################################
################################################################################################################################################################################################
################################################################################################################################################################################################
################################################################################################################################################################################################
################################################################################################################################################################################################
################################################################################################################################################################################################
################################################################################################################################################################################################
################################################################################################################################################################################################
################################################################################################################################################################################################
################################################################################################################################################################################################
################################################################################################################################################################################################
################################################################################################################################################################################################
################################################################################################################################################################################################
################################################################################################################################################################################################
################################################################################################################################################################################################
################################################################################################################################################################################################
################################################################################################################################################################################################
################################################################################################################################################################################################
################################################################################################################################################################################################
################################################################################################################################################################################################
################################################################################################################################################################################################
################################################################################################################################################################################################
################################################################################################################################################################################################
################################################################################################################################################################################################
################################################################################################################################################################################################
################################################################################################################################################################################################
################################################################################################################################################################################################
################################################################################################################################################################################################
############################################2000001##########################################################################################2000001############################################
###########################################200000001########################################################################################200000001###########################################
##########################################20000000001######################################################################################20000000001##########################################
#########################################2000000000001####################################################################################2000000000001#########################################
########################################200000000000001##################################################################################200000000000001########################################
#######################################20000000000000001C###############################################################################20000000000000001#######################################
######################################2000000000000000001##############################################################################2000000000000000001c#####################################
#####################################200000000000000000001###########################################################################C200000000000000000001#####################################
####################################20000000000000000000001##########################################################################20000000000000000000001####################################
###################################2000000000000000000000001########################################################################2000000000000000000000001###################################
##################################200000000000000000000000001######################################################################200000000000000000000000001##################################
#################################20000000000000000000000000001####################################################################20000000000000000000000000001#################################
################################2000000000000000000000000000001##################################################################2000000000000000000000000000001################################
###############################200000000000000000000000000000001################################################################200000000000000000000000000000001###############################
##############################20000000000000000000000000000000001##############################################################20000000000000000000000000000000001##############################
#############################2000000000000000000000000000000000001############################################################2000000000000000000000000000000000001#############################
###########################C200000000000000000000000000000000000001##########################################################200000000000000000000000000000000000001############################
###########################20000000000000000000000000000000000000001########################################################20000000000000000000000000000000000000001###########################
##########################2000000000000000000000000000000000000000001######################################################2000000000000000000000000000000000000000001##########################
#########################200000000000000000000000000000000000000000001####################################################200000000000000000000000000000000000000000001#########################
########################20000000000000000000000000000000000000000000001##################################################20000000000000000000000000000000000000000000001########################
#######################2000000000000000000000000000000000000000000000001################################################2000000000000000000000000000000000000000000000001#######################
######################200000000000000000000000000000000000000000000000001##############################################200000000000000000000000000000000000000000000000001######################
#####################20000000000000000000000000000000000000000000000000001############################################20000000000000000000000000000000000000000000000000001#####################
####################2000000000000000000000000000000000000000000000000000001##########################################2000000000000000000000000000000000000000000000000000001####################
###################200000000000000000000000000000000000000000000000000000001########################################200000000000000000000000000000000000000000000000000000001###################
##################20000000000000000000000000000000000000000000000000000000001######################################20000000000000000000000000000000000000000000000000000000001##################
#################2000000000000000000000000000000000000000000000000000000000001####################################2000000000000000000000000000000000000000000000000000000000001#################
################200000000000000000000000000000000000000000000000000000000000001##################################200000000000000000000000000000000000000000000000000000000000001################
###############20000000000000000000000000000000000000000000000000000000000000001###############################c20000000000000000000000000000000000000000000000000000000000000001###############
##############2000000000000000000000000000000000000000000000000000000000000000001##############################2000000000000000000000000000000000000000000000000000000000000000001##############
#############200000000000000000000000000000000000000000000000000000000000000000001############################200000000000000000000000000000000000000000000000000000000000000000001#############
############20000000000000000000000000000000000000000000000000000000000000000000001c#########################20000000000000000000000000000000000000000000000000000000000000000000001############
###########2000000000000000000000000000000000000000000000000000000000000000000000001########################2000000000000000000000000000000000000000000000000000000000000000000000001###########
##########200000000000000000000000000000000000000000000000000000000000000000000000001######################200000000000000000000000000000000000000000000000000000000000000000000000001##########
#########20000000000000000000000000000000000000000000000000000000000000000000000000001####################20000000000000000000000000000000000000000000000000000000000000000000000000001c########
########2000000000000000000000000000000000000000000000000000000000000000000000000000001##################2000000000000000000000000000000000000000000000000000000000000000000000000000001########
#######200000000000000000000000000000000000000000000000000000000000000000000000000000001################200000000000000000000000000000000000000000000000000000000000000000000000000000001#######
######20000000000000000000000000000000000000000000000000000000000000000000000000000000001##############20000000000000000000000000000000000000000000000000000000000000000000000000000000001######
#####2000000000000000000000000000000000000000000000000000000000000000000000000000000000001############2000000000000000000000000000000000000000000000000000000000000000000000000000000000001#####
000000000000000000000000000000000000000000000000000000000000000000000000000000000000000000000000000000000000000000000000000000000000000000000000000000000000000000000000000000000000000000000000
000000000000000000000000000000000000000000000000000000000000000000000000000000000000000000000000000000000000000000000000000000000000000000000000000000000000000000000000000000000000000000000000
000000000000000000000000000000000000000000000000000000000000000000000000000000000000000000000000000000000000000000000000000000000000000000000000000000000000000000000000000000000000000000000000
000000000000000000000000000000000000000000000000000000000000000000000000000000000000000000000000000000000000000000000000000000000000000000000000000000000000000000000000000000000000000000000000
000000000000000000000000000000000000000000000000000000000000000000000000000000000000000000000000000000000000000000000000000000000000000000000000000000000000000000000000000000000000000000000000
000000000000000000000000000000000000000000000000000000000000000000000000000000000000000000000000000000000000000000000000000000000000000000000000000000000000000000000000000000000000000000000000
000000000000000000000000000000000000000000000000000000000000000000000000000000000000000000000000000000000000000000000000000000000000000000000000000000000000000000000000000000000000000000000000
000000000000000000000000000000000000000000000000000000000000000000000000000000000000000000000000000000000000000000000000000000000000000000000000000000000000000000000000000000000000000000000000
000000000000000000000000000000000000000000000000000000000000000000000000000000000000000000000000000000000000000000000000000000000000000000000000000000000000000000000000000000000000000000000000
000000000000000000000000000000000000000000000000000000000000000000000000000000000000000000000000000000000000000000000000000000000000000000000000000000000000000000000000000000000000000000000000
000000000000000000000000000000000000000000000000000000000000000000000000000000000000000000000000000000000000000000000000000000000000000000000000000000000000000000000000000000000000000000000000
000000000000000000000000000000000000000000000000000000000000000000000000000000000000000000000000000000000000000000000000000000000000000000000000000000000000000000000000000000000000000000000000
000000000000000000000000000000000000000000000000000000000000000000000000000000000000000000000000000000000000000000000000000000000000000000000000000000000000000000000000000000000000000000000000
000000000000000000000000000000000000000000000000000000000000000000000000000000000000000000000000000000000000000000000000000000000000000000000000000000000000000000000000000000000000000000000000
000000000000000000000000000000000000000000000000000000000000000000000000000000000000000000000000000000000000000000000000000000000000000000000000000000000000000000000000000000000000000000000000
000000000000000000000000000000000000000000000000000000000000000000000000000000000000000000000000000000000000000000000000000000000000000000000000000000000000000000000000000000000000000000000000
000000000000000000000000000000000000000000000000000000000000000000000000000000000000000000000000000000000000000000000000000000000000000000000000000000000000000000000000000000000000000000000000
000000000000000000000000000000000000000000000000000000000000000000000000000000000000000000000000000000000000000000000000000000000000000000000000000000000000000000000000000000000000000000000000
000000000000000000000000000000000000000000000000000000000000000000000000000000000000000000000000000000000000000000000000000000000000000000000000000000000000000000000000000000000000000000000000
000000000000000000000000000000000000000000000000000000000000000000000000000000000000000000000000000000000000000000000000000000000000000000000000000000000000000000000000000000000000000000000000