192 128
################################################################################################################################################################################################
################################################################################################################################################################################################
################################################################################################################################################################################################
################################################################################################################################################################################################
################################################################################################################################################################################################
################################################################################################################################################################################################
################################################################################################################################################################################################
################################################################################################################################################################################################
################################################################################################################################################################################################
################################################################################################################################################################################################
################################################################################################################################################################################################
################################################################################################################################################################################################
################################################################################################################################################################################################
################################################################################################################################################################################################
################################################################################################################################################################################################
################################################################################################################################################################################################
################################################################################################################################################################################################
################################################################################################################################################################################################
################################################################################################################################################################################################
################################################################################################################################################################################################
################################################################################################################################################################################################
################################################################################################################################################################################################
################################################################################################################################################################################################
################################################################################################################################################################################################
################################################################################################################################################################################################
################################################################################################################################################################################################
################################################################################################################################################################################################
################################################################################################################################################################################################
################################################################################################################################################################################################
################################################################################################################################################################################################
################################################################################################################################################################################################
################################################################################################################################################################################################
################################################################################################################################################################################################
################################################################################################################################################################################################
################################################################################################################################################################################################
################################################################################################################################################################################################
################################################################################################################################################################################################
################################################################################################################################################################################################
################################################################################################################################################################################################
################################################################################################################################################################################################
################################################################################################################################################################################################
################################################################################################################################################################################################
################################################################################################################################################################################################
################################################################################################################################################################################################
################################################################################################################################################################################################
################################################################################################################################################################################################
################################################################################################################################################################################################
################################################################################################################################################################################################
################################################################################################################################################################################################
################################################################################################################################################################################################
################################################################################################################################################################################################
################################################################################################################################################################################################
################################################################################################################################################################################################
################################################################################################################################################################################################
################################################################################################################################################################################################
################################################################################################################################################################################################
################################################################################################################################################################################################
################################################################################################################################################################################################
################################################################################################################################################################################################
################################################################################################################################################################################################
################################################################################################################################################################################################
################################################################################################################################################################################################
################################################################################################################################################################################################
################################################################################################################################################################################################
################################################################################################################################################################################################
################################################################################################################################################################################################
################################################################################################################################################################################################
################################################################################################################################################################################################
################################################################################################################################################################################################
################################################################################################################################################################################################
00000000000001####################################################################################################################################################################20000000000000
000000000000001##################################################################################################################################################################200000000000000
0000000000000001################################################################################################################################################################2000000000000000
00000000000000001##############################################################################################################################################################20000000000000000
000000000000000001############################################################################################################################################################200000000000000000
0000000000000000001c#########################################################################################################################################################2000000000000000000
00000000000000000001########################################################################################################################################################20000000000000000000
000000000000000000001#####################################################################################################################################################c200000000000000000000
0000000000000000000001####################################################################################################################################################2000000000000000000000
00000000000000000000001##################################################################################################################################################20000000000000000000000
000000000000000000000001################################################################################################################################################200000000000000000000000
0000000000000000000000001##############################################################################################################################################2000000000000000000000000
00000000000000000000000001############################################################################################################################################20000000000000000000000000
000000000000000000000000001##########################################################################################################################################200000000000000000000000000
00000000000000000000000000000000000000001##############################################################################################################20000000000000000000000000000000000000000
000000000000000000000000000000000000000001############################################################################################################200000000000000000000000000000000000000000
0000000000000000000000000000000000000000001##########################################################################################################2000000000000000000000000000000000000000000
00000000000000000000000000000000000000000001########################################################################################################20000000000000000000000000000000000000000000
000000000000000000000000000000000000000000001######################################################################################################200000000000000000000000000000000000000000000
0000000000000000000000000000000000000000000001####################################################################################################2000000000000000000000000000000000000000000000
00000000000000000000000000000000000000000000001##################################################################################################20000000000000000000000000000000000000000000000
000000000000000000000000000000000000000000000001c###############################################################################################200000000000000000000000000000000000000000000000
0000000000000000000000000000000000000000000000001##############################################################################################2000000000000000000000000000000000000000000000000
00000000000000000000000000000000000000000000000001############################################################################################20000000000000000000000000000000000000000000000000
000000000000000000000000000000000000000000000000001##########################################################################################200000000000000000000000000000000000000000000000000
0000000000000000000000000000000000000000000000000001########################################################################################2000000000000000000000000000000000000000000000000000
00000000000000000000000000000000000000000000000000001######################################################################################20000000000000000000000000000000000000000000000000000
000000000000000000000000000000000000000000000000000001##############################################################################c#####200000000000000000000000000000000000000000000000000000
00000000000000000000000000000000000000000000000000000000000000000001########################################################20000000000000000000000000000000000000000000000000000000000000000000
000000000000000000000000000000000000000000000000000000000000000000001######################################################200000000000000000000000000000000000000000000000000000000000000000000
0000000000000000000000000000000000000000000000000000000000000000000001####################################################2000000000000000000000000000000000000000000000000000000000000000000000
00000000000000000000000000000000000000000000000000000000000000000000001##################################################20000000000000000000000000000000000000000000000000000000000000000000000
000000000000000000000000000000000000000000000000000000000000000000000001################################################200000000000000000000000000000000000000000000000000000000000000000000000
0000000000000000000000000000000000000000000000000000000000000000000000001##############################################2000000000000000000000000000000000000000000000000000000000000000000000000
00000000000000000000000000000000000000000000000000000000000000000000000001############################################20000000000000000000000000000000000000000000000000000000000000000000000000
000000000000000000000000000000000000000000000000000000000000000000000000001##########################################200000000000000000000000000000000000000000000000000000000000000000000000000
0000000000000000000000000000000000000000000000000000000000000000000000000001########################################2000000000000000000000000000000000000000000000000000000000000000000000000000
00000000000000000000000000000000000000000000000000000000000000000000000000001######################################20000000000000000000000000000000000000000000000000000000000000000000000000000
000000000000000000000000000000000000000000000000000000000000000000000000000001####################################200000000000000000000000000000000000000000000000000000000000000000000000000000
0000000000000000000000000000000000000000000000000000000000000000000000000000001##################################2000000000000000000000000000000000000000000000000000000000000000000000000000000
00000000000000000000000000000000000000000000000000000000000000000000000000000001################################20000000000000000000000000000000000000000000000000000000000000000000000000000000
000000000000000000000000000000000000000000000000000000000000000000000000000000001##############c###############200000000000000000000000000000000000000000000000000000000000000000000000000000000
000000000000000000000000000000000000000000000000000000000000000000000000000000000000000000000000000000000000000000000000000000000000000000000000000000000000000000000000000000000000000000000000
000000000000000000000000000000000000000000000000000000000000000000000000000000000000000000000000000000000000000000000000000000000000000000000000000000000000000000000000000000000000000000000000
000000000000000000000000000000000000000000000000000000000000000000000000000000000000000000000000000000000000000000000000000000000000000000000000000000000000000000000000000000000000000000000000
000000000000000000000000000000000000000000000000000000000000000000000000000000000000000000000000000000000000000000000000000000000000000000000000000000000000000000000000000000000000000000000000
000000000000000000000000000000000000000000000000000000000000000000000000000000000000000000000000000000000000000000000000000000000000000000000000000000000000000000000000000000000000000000000000
000000000000000000000000000000000000000000000000000000000000000000000000000000000000000000000000000000000000000000000000000000000000000000000000000000000000000000000000000000000000000000000000
000000000000000000000000000000000000000000000000000000000000000000000000000000000000000000000000000000000000000000000000000000000000000000000000000000000000000000000000000000000000000000000000
000000000000000000000000000000000000000000000000000000000000000000000000000000000000000000000000000000000000000000000000000000000000000000000000000000000000000000000000000000000000000000000000
000000000000000000000000000000000000000000000000000000000000000000000000000000000000000000000000000000000000000000000000000000000000000000000000000000000000000000000000000000000000000000000000
000000000000000000000000000000000000000000000000000000000000000000000000000000000000000000000000000000000000000000000000000000000000000000000000000000000000000000000000000000000000000000000000
000000000000000000000000000000000000000000000000000000000000000000000000000000000000000000000000000000000000000000000000000000000000000000000000000000000000000000000000000000000000000000000000
000000000000000000000000000000000000000000000000000000000000000000000000000000000000000000000000000000000000000000000000000000000000000000000000000000000000000000000000000000000000000000000000
000000000000000000000000000000000000000000000000000000000000000000000000000000000000000000000000000000000000000000000000000000000000000000000000000000000000000000000000000000000000000000000000
000000000000000000000000000000000000000000000000000000000000000000000000000000000000000000000000000000000000000000000000000000000000000000000000000000000000000000000000000000000000000000000000
000000000000000000000000000000000000000000000000000000000000000000000000000000000000000000000000000000000000000000000000000000000000000000000000000000000000000000000000000000000000000000000000
000000000000000000000000000000000000000000000000000000000000000000000000000000000000000000000000000000000000000000000000000000000000000000000000000000000000000000000000000000000000000000000000