192 128
################################################################################################################################################################################################
################################################################################################################################################################################################
################################################################################################################################################################################################
################################################################################################################################################################################################
################################################################################################################################################################################################
################################################################################################################################################################################################
################################################################################################################################################################################################
################################################################################################################################################################################################
################################################################################################################################################################################################
################################################################################################################################################################################################
################################################################################################################################################################################################
################################################################################################################################################################################################
################################################################################################################################################################################################
################################################################################################################################################################################################
################################################################################################################################################################################################
################################################################################################################################################################################################
################################################################################################################################################################################################
################################################################################################################################################################################################
################################################################################################################################################################################################
################################################################################################################################################################################################
################################################################################################################################################################################################
################################################################################################################################################################################################
################################################################################################################################################################################################
################################################################################################################################################################################################
################################################################################################################################################################################################
################################################################################################################################################################################################
################################################################################################################################################################################################
################################################################################################################################################################################################
################################################################################################################################################################################################
################################################################################################################################################################################################
################################################################################################################################################################################################
################################################################################################################################################################################################
################################################################################################################################################################################################
################################################################################################################################################################################################
################################################################################################################################################################################################
################################################################################################################################################################################################
################################################################################################################################################################################################
################################################################################################################################################################################################
################################################################################################################################################################################################
################################################################################################################################################################################################
################################################################################################################################################################################################
################################################################################################################################################################################################
################################################################################################################################################################################################
################################################################################################################################################################################################
################################################################################################################################################################################################
################################################################################################################################################################################################
################################################################################################################################################################################################
################################################################################################################################################################################################
################################################################################################################################################################################################
################################################################################################################################################################################################
################################################################################################################################################################################################
################################################################################################################################################################################################
################################################################################################################################################################################################
################################################################################################################################################################################################
################################################################################################################################################################################################
################################################################################################################################################################################################
################################################################################################################################################################################################
################################################################################################################################################################################################
################################################################################################################################################################################################
################################################################################################################################################################################################
################################################################################################################################################################################################
################################################################################################################################################################################################
####################################################################################################c###########################################################################################
################################################################################################################################################################################################
##################################################################################################20001#########################################################################################
#################################################################################################2000000001#######################c#############################################################
################################################################################################20000000000001##################################################################################
###############################################################################################200000000000000001###############################################################################
##############################################################################################20000000000000000001##############################################################################
############################################################################################20000000000000000000001#############################################################################
###########################################################################################200000000000000000000003#############################################################################
##########################################################################################200000000000000000000000##############################################################################
############################################################201##########################2000000000000000000000000##############################################################################
###########################################################20001#212121##c##############20000000000000000000000003##############################################################################
##########################################################200000000000000000000000000000000000000000000000000000000001##########################################################################
########################################################200000000000000000000000000000000000000000000000000000000000001#########################################################################
#######################################################200000000000000000000000000000000000000000000000000000000000000001#######################################################################
######################################################20000000000000000000000000000000000000000000000000000000000000000001######################################################################
###################################################2000000000000000000000000000000000000000000000000000000000000000000000001####################################################################
##################################################200000000000000000000000000000000000000000000000000000000000000000000000000001################################################################
#################################################20000000000000000000000000000000000000000000000000000000000000000000000000000001###############################################################
################################################20000000000000000000000000000000000000000000000000000000000000000000000000000000001#############################################################
###############################################2000000000000000000000000000000000000000000000000000000000000000000000000000000000001############################################################
############################################200000000000000000000000000000000000000000000000000000000000000000000000000000000000000001##########################################################
###########################################20000000000000000000000000000000000000000000000000000000000000000000000000000000000000000001#########################################################
##########################################2000000000000000000000000000000000000000000000000000000000000000000000000000000000000000000001########################################################
########################################2000000000000000000000000000000000000000000000000000000000000000000000000000000000000000000000001#######################################################
#######################################2000000000000000000000000000000000000000000000000000000000000000000000000000000000000000000000000001#####################################################
######################################2000000000000000000000000000000000000000000000000000000000000000000000000000000000000000000000000000001###################################################
#####################################2000000000000000000000000000000000000000000000000000000000000000000000000000000000000000000000000000000001#################################################
####################################200000000000000000000000000000000000000000000000000000000000000000000000000000000000000000000000000000000001################################################
###################################20000000000000000000000000000000000000000000000000000000000000000000000000000000000000000000000000000000000001###############################################
##################################2000000000000000000000000000000000000000000000000000000000000000000000000000000000000000000000000000000000000001##############################################
#################################200000000000000000000000000000000000000000000000000000000000000000000000000000000000000000000000000000000000000001#############################################
################################20000000000000000000000000000000000000000000000000000000000000000000000000000000000000000000000000000000000000000001############################################
###############################2000000000000000000000000000000000000000000000000000000000000000000000000000000000000000000000000000000000000000000001###################200000##################
##############################200000000000000000000000000000000000000000000000000000000000000000000000000000000000000000000000000000000000000000000001T################2000000##################
##############################0000000000000000000000000000000000000000000000000000000000000000000000000000000000000000000000000000000000000000000000001###############20000000##################
#########################c###000000000000000000000000000000000000000000000000000000000000000000000000000000000000000000000000000000000000000000000000000#############2000000000#################
############################20000000000000000000000000000000000000000000000000000000000000000000000000000000000000000000000000000000000000000000000000000###########20000000000#########c#######
000001t##############200000000000000000000000000000000000000000000000000000000000000000000000000000000000000000000000000000000000000000000000000000000000000000000000000000000000000000000000000
0000001#############2000000000000000000000000000000000000000000000000000000000000000000000000000000000000000000000000000000000000000000000000000000000000000000000000000000000000000000000000000
00000001###########20000000000000000000000000000000000000000000000000000000000000000000000000000000000000000000000000000000000000000000000000000000000000000000000000000000000000000000000000000
000000001#########200000000000000000000000000000000000000000000000000000000000000000000000000000000000000000000000000000000000000000000000000000000000000000000000000000000000000000000000000000
0000000001#######2000000000000000000000000000000000000000000000000000000000000000000000000000000000000000000000000000000000000000000000000000000000000000000000000000000000000000000000000000000
00000000001#####20000000000000000000000000000000000000000000000000000000000000000000000000000000000000000000000000000000000000000000000000000000000000000000000000000000000000000000000000000000
000000000000000000000000000000000000000000000000000000000000000000000000000000000000000000000000000000000000000000000000000000000000000000000000000000000000000000000000000000000000000000000000
000000000000000000000000000000000000000000000000000000000000000000000000000000000000000000000000000000000000000000000000000000000000000000000000000000000000000000000000000000000000000000000000
000000000000000000000000000000000000000000000000000000000000000000000000000000000000000000000000000000000000000000000000000000000000000000000000000000000000000000000000000000000000000000000000
000000000000000000000000000000000000000000000000000000000000000000000000000000000000000000000000000000000000000000000000000000000000000000000000000000000000000000000000000000000000000000000000
000000000000000000000000000000000000000000000000000000000000000000000000000000000000000000000000000000000000000000000000000000000000000000000000000000000000000000000000000000000000000000000000
000000000000000000000000000000000000000000000000000000000000000000000000000000000000000000000000000000000000000000000000000000000000000000000000000000000000000000000000000000000000000000000000
000000000000000000000000000000000000000000000000000000000000000000000000000000000000000000000000000000000000000000000000000000000000000000000000000000000000000000000000000000000000000000000000
000000000000000000000000000000000000000000000000000000000000000000000000000000000000000000000000000000000000000000000000000000000000000000000000000000000000000000000000000000000000000000000000
000000000000000000000000000000000000000000000000000000000000000000000000000000000000000000000000000000000000000000000000000000000000000000000000000000000000000000000000000000000000000000000000
000000000000000000000000000000000000000000000000000000000000000000000000000000000000000000000000000000000000000000000000000000000000000000000000000000000000000000000000000000000000000000000000
000000000000000000000000000000000000000000000000000000000000000000000000000000000000000000000000000000000000000000000000000000000000000000000000000000000000000000000000000000000000000000000000
000000000000000000000000000000000000000000000000000000000000000000000000000000000000000000000000000000000000000000000000000000000000000000000000000000000000000000000000000000000000000000000000
000000000000000000000000000000000000000000000000000000000000000000000000000000000000000000000000000000000000000000000000000000000000000000000000000000000000000000000000000000000000000000000000
000000000000000000000000000000000000000000000000000000000000000000000000000000000000000000000000000000000000000000000000000000000000000000000000000000000000000000000000000000000000000000000000
000000000000000000000000000000000000000000000000000000000000000000000000000000000000000000000000000000000000000000000000000000000000000000000000000000000000000000000000000000000000000000000000
000000000000000000000000000000000000000000000000000000000000000000000000000000000000000000000000000000000000000000000000000000000000000000000000000000000000000000000000000000000000000000000000
000000000000000000000000000000000000000000000000000000000000000000000000000000000000000000000000000000000000000000000000000000000000000000000000000000000000000000000000000000000000000000000000
000000000000000000000000000000000000000000000000000000000000000000000000000000000000000000000000000000000000000000000000000000000000000000000000000000000000000000000000000000000000000000000000
000000000000000000000000000000000000000000000000000000000000000000000000000000000000000000000000000000000000000000000000000000000000000000000000000000000000000000000000000000000000000000000000
000000000000000000000000000000000000000000000000000000000000000000000000000000000000000000000000000000000000000000000000000000000000000000000000000000000000000000000000000000000000000000000000
000000000000000000000000000000000000000000000000000000000000000000000000000000000000000000000000000000000000000000000000000000000000000000000000000000000000000000000000000000000000000000000000
000000000000000000000000000000000000000000000000000000000000000000000000000000000000000000000000000000000000000000000000000000000000000000000000000000000000000000000000000000000000000000000000
